##############
#...........#
#............#
#....######..#
#....#....#..#
#...... . ...#..#
############# 12